11111111
10000001
10000001
10010001
100100N1
10000001
10000001
11111111