1111111111
1001000001
1000000001
1100N00001
1010000001
1000000001
1111111111