NO textures/NO.png
SO textures/SO.png
WE textures/WE.png
EA textures/EA.png

F 34,139,34
C 135,206,255

1111111111111111111
1000000000000000001
1000000000000000001
1000000000000000001
1000000000000000001
1000000000000000001
100000000N000000001
1000000000000000001
1111111111111111111