11111111111111
10010000000C01
10000111110001
1P0011E0000001
10010000000C01
11111111111111