11111111111111
1P010C0000C001
10000B11101111
10C011E0000001
10010B0000C001
11111111111111