11111111111111
10010000000001
10000111101111
10001100E00001
10010000000001
11111111111111