11111111111111
1P010C0000C001
10000111101111
10C0111E100001
1001000100C001
11111111111111