11111111
10000001
10000001
10000E01
1P000001
1000C001
10000001
11111111