11111111111111
1P010C0000C001
10000111101111
10C011E0000001
10010000W0C001
11111111111111