11111111111111
1P010C0000C001
1000011B101111
10C011BEB00001
1001000B00C001
11111111111111